xxxxxxxxxxxxxxxxxxxxxxxxxxxxxxxx
x               x              x
x               x              x
x               x              x
x               x              x
x               x              x
x               x              x
x               x              x
x               x              x
x               5              x
x  %            5           $  x
xxxxxxxxxxxxx44xxx33xxxxxxxxxxxx
x               x              x
x           #   x  @           x
xx22xxxxxxxxxxxxxxxxxxxxxxxx11xx
x               x              x
x !           P x p            x
xxxxxxxxxxxxxxxxxxxxxxxxxxxxxxxx