xxxxxxxxxxxxxxx
x             x
x             x
x   X  X      x
x             x
x             x
x     X       x
x             x
xxxxxxxxxxxxxxx